E00101010101
010010000011
001010111011
101010100001
101000111011
100010100001
101110101111
100000101001
110111101011
110000001111
110110100011
11011110100S
